000000000000000000000000000000000000
011100000000000000000000000000000000
000000000000000110000000000000111000
000000000000000000000000000000001000
000000000011000000000000001000000000
000011111111000000000000001000000000
000000000000100000000001111111000000
010000000000000100000000001000000000
000000000000000000000000001000000000
000000000000000010000000000000000000
000011100001110000000000000000000000
000001000001010000000000000000011000
000001000001110000000000000000000000
000001000000010000000000000000000000
000001000000100000000000000111110000
000000000000000000000000000000001000
000000000000100000000000000000101000
000010000000110000000000000001110000
000000000000000000000000000000000000
000000010000000000000000000000000000
000000000000011111111111110000000000
000000000000100000000000010000000000
000000000001000000000111010000000000
000110000000000000000100010000000000
000110000000000000000111110000000000
000000000001111000000000000000000000
000000000111111000000000000000000000
000000001111111100000000000000010000
000011111111111111111000000000000000
000000000000000000000000000000000000